##############################
#o         #   ##   # ### ####
# ###### # # #    # # ### ####
# #   ## #   # #### # ###   ##
#   # ##  ###    #  #  ## ####
##### #     # ##### ##    ####
#   # ##### #   #   # # #    #
# # #    ## # #### ## # # ####
# # # ##      ##      # # ####
# # # ####### ## ###### #   ##
# #   ##   # ## ###### ###   #
# ###### # #####  #        # #
#        # #     ##### ### #  
# ######## ##### # ### ### # #
#     # ## ##### ###       ###
##### # ## #      ######## # #
#     # ## ## ###        #   #
# # ###       ###### ####### #
# #    ### ##      #         #
##############################