######
#o #  
# ## #
#  # #
##   #
######