###########
#o   #  ###
# ## ##   #
#  #    # #
# #### ## #
#       #  
###########